万	萬
与	與
丐	匃
丑	醜
专	專
世	乫
业	榠
丛	叢
东	東
丝	絲
两	兩
严	嚴
丧	喪
个	個
丰	豷
临	舝
为	為
丽	麗
举	舉
乃	廼
么	麽
义	義
乌	烏
乐	樂
乔	喬
乘	乗
习	習
乡	鄉
书	書
买	賗
乱	亂
争	爭
亏	虧
云	雲
亘	亙
亚	亞
产	産
亩	畝
亲	觝
亵	襝
亿	億
仅	僪
仆	僿
仇	讎
从	従
仑	侖
仓	倉
仙	僲
仪	儀
们	們
价	價
仿	倣
众	衆
优	優
伙	夥
会	會
伛	傴
伞	傘
伟	偉
传	傳
伡	俥
伤	傷
伥	倀
伦	倫
伧	傖
伪	偽
伫	佇
似	佀
体	軆
你	妳
佣	傭
佥	僱
佩	珮
侄	姪
侉	唀
侠	俠
侥	僥
侦	偵
侧	側
侨	僺
侩	儈
侪	儕
侬	儂
侯	矦
俊	儁
俦	儔
俨	儼
俩	倆
俪	儷
俭	儉
俯	頫
倘	償
倦	勌
债	債
倾	僡
假	叚
偬	傯
偷	媢
偻	僥
偾	僨
傥	儻
傧	儐
储	儲
傩	儺
傫	儽
傻	儍
僵	殭
儿	兒
克	剋
兔	兎
党	黨
兜	兠
兰	蘭
关	阷
兴	興
养	餬
兽	玣
冁	囅
冈	岡
冉	冄
冒	冐
写	冩
军	軍
农	農
冢	塿
冤	寃
冯	駎
冱	泎
冲	衝
况	況
冻	凍
净	凈
凄	渄
凝	聹
凤	鴓
凫	鴌
凭	剅
凯	刾
凳	櫈
击	撃
函	圅
凿	鑿
刃	剈
刍	芻
刖	蛂
刘	劉
则	則
刚	剛
创	創
删	刪
刨	鉫
刬	剗
刭	剄
刽	劊
刿	劌
剀	剴
剁	刴
剂	劑
剃	髰
剐	剮
剑	劍
剧	劇
剽	勡
剿	勦
劝	勸
办	辦
务	務
劢	勱
动	動
劫	刼
劭	卲
励	勵
劲	勁
劳	勞
势	勢
勋	勛
勖	勗
匆	恠
匝	帀
匦	卶
匮	卼
区	區
医	醫
华	萢
协	協
单	單
卖	賣
卜	蕁
卢	眗
卤	漟
卧	舙
卫	衛
卮	巵
卯	夘
厂	弒
厄	戹
厅	廳
历	歷
厉	厲
压	壓
厌	厭
厍	厙
厕	廁
厘	釐
厣	厴
厨	弉
厩	廄
县	縣
叁	參
参	參
叆	靉
双	雙
发	發
变	變
叙	敘
叠	曡
叩	敂
只	隻
叶	葉
号	號
叹	嘆
叽	嘰
吃	喫
吊	弔
吓	嚇
吗	嗎
吝	恡
吟	唫
吣	吢
吨	噸
听	聽
启	啓
吻	脀
呃	呝
呆	獃
呓	囈
呕	噄
呖	嚦
呗	唄
员	唗
呛	嗆
呜	嗚
呲	齜
呼	噁
和	咊
咏	詠
咒	呪
咙	嚨
咛	嚀
咝	噝
咩	哶
咬	齩
咱	喒
咿	吚
响	響
哑	啞
哒	噠
哓	嘵
哔	嗶
哕	噦
哗	噖
哙	噲
哜	嚌
哝	噥
哟	喲
哲	喆
唇	脣
唛	噊
唠	噝
唢	嗩
唣	唕
啃	齦
啖	啗
啧	噆
啬	嗇
啭	囀
啮	噛
啸	噕
啼	嗁
喂	餧
喋	啑
喷	噴
喽	嘾
喾	嚳
嗥	噑
嗫	囁
嗳	噯
嘤	嚶
嘱	囑
嘲	謿
嘻	譆
噜	嚕
噪	喿
嚣	嚻
回	迴
团	坒
园	園
围	圍
囵	圇
国	國
图	坉
圆	坅
圣	聖
圬	杇
圭	珪
圹	壙
场	場
址	阯
坏	壞
块	塳
坚	堅
坛	壇
坜	壢
坝	壩
坟	墳
坠	墜
坤	堃
垄	壟
垆	壚
垒	壘
垛	垜
垦	墾
垩	惡
垫	墊
垭	埡
垲	塶
垴	堖
埙	塤
埚	堝
堑	塹
堕	墮
堙	陻
堤	隄
塍	堘
塔	墖
塞	僿
墩	墪
壮	壯
声	聲
壳	殻
壶	壺
壸	壼
处	處
备	備
复	復
夜	亱
头	頭
夹	奱
夺	妟
奁	妝
奂	妀
奋	奮
奖	妜
奶	嬭
奸	姦
妆	妝
妇	媎
妈	媽
妊	姙
妍	姸
妒	妬
妙	玵
妩	嫵
妪	嫗
妫	嬀
姊	姉
姗	姍
姻	媋
娄	婁
娅	媔
娆	嬈
娇	嬌
娈	宒
娘	孃
娲	媧
娴	嫻
婪	惏
婴	嬰
婵	嬋
婶	嬸
婿	壻
嫒	嬡
嫔	嬪
嫖	阸
孙	宱
学	壆
孪	孿
孽	寊
宁	寍
宝	寳
实	實
宠	寵
审	審
宪	寰
宴	讌
宽	寬
宾	賓
寝	寢
察	詧
对	對
寻	尋
导	導
寿	壽
将	將
尔	爾
尘	塵
尝	噇
尧	堯
尴	尷
尽	儘
层	層
屉	屜
属	屬
屦	屨
屿	巣
岁	歲
岂	豰
岖	嶇
岗	崗
岘	峴
岙	巗
岚	嵐
岛	島
岩	巖
岭	巟
岳	嶽
岿	巋
峄	巉
峡	峽
峤	嶠
峦	巒
峨	峩
峰	峯
崂	嶗
崃	崍
崖	崕
崭	嶄
嵘	巚
嵚	嶔
嵝	嶁
嵩	崧
巅	巓
巡	廵
巩	鞏
巯	巰
币	幣
帅	帥
师	師
帏	幃
帐	帳
帘	簾
帙	袟
帜	幟
带	帶
席	蓆
帮	幫
帱	幬
帻	幘
帼	幗
幕	幙
幞	襩
并	乲
广	弙
庄	莊
庆	慶
床	牀
庐	廬
庑	弔
库	庫
应	應
庙	弐
庞	龐
废	弖
庶	庻
廉	亷
开	開
弁	覍
异	異
弃	棄
张	張
弥	彌
弦	絣
弪	弳
弯	彎
弹	彈
强	強
归	歸
当	當
录	録
彗	篲
彝	彜
彷	倣
彻	徹
径	徑
徊	佪
徕	徠
徦	叚
德	惪
忆	憶
忏	懺
忧	憂
忾	愾
怀	懷
态	慴
怂	憐
怃	弔
怄	憏
怅	悵
怆	愴
怜	憐
怪	恠
总	總
怼	懟
怿	懌
恋	宒
恍	恥
恒	恆
恤	卹
恪	愙
恳	懇
恶	惡
恸	憅
恺	愷
恻	惻
恽	惲
恿	怺
悍	猺
悫	愨
悬	懸
悭	慳
悯	憫
惊	驚
惠	僡
惧	懼
惨	慿
惩	懲
惫	憊
惬	愜
惭	憁
惮	憚
惯	憈
惰	憜
愈	瘉
愤	憤
愦	憒
慑	慴
慷	忼
憔	顦
憝	憞
憩	憇
懑	懣
懒	懶
戋	戔
戏	戲
戗	戧
战	戰
戛	戞
截	巀
戬	戩
戮	剹
扇	搧
扎	紥
扑	撲
扛	摃
执	執
扩	攗
扪	捫
扫	掃
扬	損
扯	撦
扰	擾
扼	搤
折	摺
抟	摶
抠	摳
抡	掄
抢	搶
护	護
报	報
抬	攅
抻	捵
担	擔
拐	枴
拖	拕
拟	儗
拢	攏
拣	揀
拥	擁
拦	攔
拧	攓
拨	撥
择	擇
挂	掛
挛	攣
挝	撾
挞	撻
挟	挾
挠	撓
挡	擋
挢	撟
挤	攄
挥	揮
挲	挱
挽	輓
捂	摀
捆	綑
捍	抜
捏	搃
捞	撈
损	損
捡	撿
捣	搗
据	據
捶	搥
掳	擄
掴	摑
掷	攕
掸	撣
掺	摻
掼	摜
插	挿
揪	揫
揸	摣
揽	攬
揿	撳
搀	攙
搁	攔
搂	摟
搅	撹
携	攜
摄	攝
摅	攄
摆	擺
摈	攑
摊	攤
摛	攡
摭	拓
撄	攖
撑	橕
撵	攆
撷	攛
撸	擼
撺	攛
擂	祑
操	撡
擞	擻
攒	攅
收	収
效	俲
敌	敵
救	捄
敕	勅
敛	斂
数	數
斋	斎
斓	斕
斗	魕
斩	斬
断	斷
旋	鏇
无	無
旧	舊
时	時
旷	曠
昏	昬
昙	曇
映	暎
春	萵
昫	暘
昭	炤
昵	暱
昼	晝
显	顯
晋	晉
晒	曬
晓	暁
晔	曄
晕	暈
晖	暉
晰	晳
暂	暫
暖	煖
暧	曖
曦	爋
曲	黡
望	杛
术	術
朵	朶
机	檆
杀	殺
杂	雜
权	権
村	邨
杠	槓
条	條
来	來
杨	楊
杩	榪
杭	斻
杯	梘
杰	傑
松	鬆
极	榦
构	構
枞	樅
枢	樞
枣	棗
枥	櫪
枧	梘
枨	棖
枪	槍
枫	楓
枭	梟
柏	栢
柜	匮
柠	檸
柳	梡
柽	檉
柿	柹
栀	梔
标	標
栈	棧
栉	櫛
栊	櫳
栋	棟
栌	櫨
栎	櫟
栏	欄
树	樹
栖	棲
样	様
栾	欒
桌	棹
桠	椏
桡	橈
桢	榚
档	檔
桤	榿
桥	橋
桦	樺
桧	檜
桨	槳
桩	樁
梁	樑
梅	榤
梦	夢
梨	棃
梼	檮
检	撿
棕	椶
棰	箠
棹	櫂
椁	槨
椟	櫝
椠	槧
椤	欏
楂	樝
楠	枏
楦	榗
楼	樓
概	槩
榄	欖
榇	櫬
榉	櫸
槁	槀
槛	檻
槟	檳
槠	櫧
樯	檣
樱	櫻
樽	罇
橛	橜
橹	櫓
橼	櫞
檐	簷
欢	歡
欣	俽
欤	歟
欧	畉
欲	慾
款	歟
歌	謌
歼	殲
殇	殤
残	殘
殒	殞
殓	殮
殚	殫
殡	殯
殴	毆
毂	轂
毕	畢
毙	斃
毡	氊
毵	毿
氇	氌
气	氣
氛	雰
氢	氫
氩	氬
求	裘
汇	卹
汞	鋟
污	汙
汤	湯
汹	洶
沟	溝
沣	灃
沤	漚
沥	瀝
沦	渟
沧	滄
沨	渢
沩	溈
沪	滬
沱	沲
泄	洩
泇	澐
法	灋
泞	濘
泪	涙
泶	澩
泷	瀧
泸	瀘
泺	瀟
泻	瀉
泼	潑
泽	澤
泾	涇
洁	潔
洒	灑
浃	浹
浅	淺
浆	漿
浇	澆
浈	湞
浊	濁
测	測
浍	澮
济	濟
浏	瀏
浐	漣
浑	渾
浒	漡
浓	濃
浔	潯
浚	瀎
浣	澣
涅	簈
涌	湧
涛	濤
涝	澇
涞	渮
涟	漣
涠	潿
涡	濄
涤	滌
润	潤
涧	澗
涨	漲
涩	澀
淫	滛
淳	湻
渊	測
渍	漬
渎	瀆
渐	漸
渔	漮
渗	漛
湾	灣
湿	濕
溃	潰
溅	瀝
溪	嵠
溯	泝
滞	滯
滟	灔
滠	灄
满	漨
滢	瀅
滥	瀍
滦	灤
滨	瀒
滩	灘
漓	灕
漱	潄
潆	瀠
潇	瀟
潋	瀲
潍	瀐
潜	潛
潸	澘
澄	澂
澜	瀾
濑	瀨
濒	瀕
灏	灝
灭	滅
灯	燈
灵	靈
灶	竈
灾	災
灿	爊
炀	煬
炉	爐
炖	燉
炜	煒
炝	熗
炯	焝
炸	煠
点	點
炼	煉
炽	熾
烁	爍
烂	爛
烃	焠
烛	爐
烟	煙
烦	煩
烧	燒
烨	燁
烩	爖
烫	燾
烬	燼
热	熱
焊	鋓
焖	爁
焘	燾
焰	燄
照	炤
煮	煑
煽	傓
熔	鎔
熙	熈
熹	熺
燮	爕
爱	愛
爷	爺
牍	牘
牦	犛
牵	牽
牺	犧
犁	犂
犊	犢
状	狀
犷	玡
犸	獁
犹	猶
狈	猲
狞	獰
独	獨
狭	猰
狮	獅
狯	獪
狱	獄
狲	猻
狷	獧
猃	獫
猎	玞
猕	玧
猡	玬
猫	貓
猬	蝟
献	玦
猱	玪
猿	猨
獐	麞
獭	玥
獾	貛
玑	璣
玙	璵
玚	瑒
玛	瑪
玮	瑋
环	環
现	琭
玺	璽
珍	珎
珏	玨
珐	琺
珑	瓏
珲	琿
琅	瑯
琉	瑠
琏	璱
琐	瑣
琪	璬
琴	琹
琼	瓊
琿	璡
瑰	瓌
瑷	璦
璃	琾
璇	璿
璎	瓔
瓒	瓚
瓮	罋
瓯	畉
瓶	缾
瓷	畁
甜	甛
电	電
画	畫
畅	暢
留	畱
略	畧
畴	疇
疆	畺
疏	痚
疖	皒
疗	療
疟	瘧
疠	皁
疡	瘍
疣	胾
疬	癧
疮	瘡
疯	瘋
疱	皰
症	皔
痈	癰
痉	痙
痒	皐
痨	癮
痫	癰
痴	皏
瘅	癲
瘘	瘻
瘤	癅
瘪	皌
瘫	癱
瘾	癮
瘿	癭
癞	癩
癣	癬
癫	癲
皂	皁
皋	皐
皑	皚
皱	皺
皲	皸
盍	盿
盏	眐
盐	鹽
监	眔
盖	蓋
盘	眕
眍	瞘
眠	瞑
眦	眥
眯	瞇
眷	瞔
睐	瞐
睑	瞼
睬	倸
睹	觛
睿	叡
瞅	矁
瞒	瞞
瞠	瞪
瞩	矚
矩	榘
矫	砪
矶	磯
矾	礬
矿	祐
砀	磝
码	碼
砖	磚
砗	硨
砚	硯
砜	碸
砣	砤
砧	磚
砬	磖
砺	祕
砻	礱
砾	礫
础	礱
硕	磘
硖	硤
硗	磽
确	確
碇	砱
碍	祂
碛	磧
碜	磣
碱	鹹
磷	燐
礼	秠
祃	秏
祎	禸
祗	祇
祢	禰
祯	禎
祷	禱
祸	禍
禅	秛
离	離
秆	稈
秋	秌
种	穘
秕	粃
称	穛
秸	穖
秽	穢
稃	粰
稗	粺
稚	穉
稣	穌
稳	穩
稿	穢
穑	穡
穷	竑
窃	竊
窍	竅
窑	竒
窗	窓
窜	竮
窝	竎
窥	竡
窦	竇
窭	竚
竖	竪
竞	競
笃	簐
笋	箂
笔	筽
笕	筧
笺	箋
笼	籠
笾	籩
筅	箲
筏	栰
筑	篵
筒	筩
策	箊
筘	窛
筚	篳
筛	簓
筲	蕱
筹	籭
签	簽
简	簡
箦	簀
箨	粁
箩	籮
箪	簞
箫	簫
箬	蒻
箸	筯
篅	圌
篑	簣
篓	簍
篪	竾
篮	籃
篱	籬
簖	籪
簪	簮
籁	籟
籴	糴
类	類
籼	秈
粗	麤
粜	糶
粝	糲
粪	約
粮	紌
粳	粇
粽	糵
糁	紃
糇	餱
糍	餈
糕	餻
糖	鎕
糜	蘪
糠	穅
糨	紅
糯	穤
系	繋
紧	緊
累	纍
絷	縶
綦	緇
纠	糾
纡	紆
红	紅
纣	紂
纤	縴
纥	紇
约	約
级	級
纨	紈
纩	纊
纪	紀
纫	紉
纬	緯
纭	紜
纯	純
纱	紗
纲	緑
纳	納
纵	縱
纶	綸
纷	紛
纸	紙
纹	紋
纺	紡
纽	紐
纾	紓
线	緌
绀	絚
绁	紲
绂	紱
练	練
组	絤
绅	紳
细	細
织	織
终	絢
绉	縰
绊	給
绋	絜
绌	絠
绍	絙
绎	繹
经	經
绐	絟
绑	綁
绒	絨
结	統
绔	絝
绕	繞
绗	絯
绘	纋
给	給
绚	絢
绛	絳
绝	絶
绞	絞
统	統
绡	綃
绢	絹
绣	綉
绥	綏
绦	縧
继	繼
绨	綈
绩	績
绪	緒
绫	綾
续	續
绮	綺
绯	緋
绰	綽
绱	緔
绳	纊
维	緎
绵	綿
绶	緍
绷	緓
绸	緄
绺	綹
绻	緅
综	綾
绽	綻
绾	緐
绿	緑
缀	緔
缁	緇
缂	緙
缃	緗
缅	緬
缆	纜
缇	緹
缈	緲
缉	緝
缊	縜
缋	纃
缌	緦
缎	緞
缏	緶
缐	線
缑	緱
缒	縫
缓	緩
缔	締
缕	縷
编	編
缗	緡
缘	緣
缙	縩
缚	縛
缛	縟
缜	縝
缝	縫
缠	纏
缡	縭
缢	縪
缣	縱
缤	繽
缥	縹
缦	縵
缧	縲
缨	纓
缩	縮
缪	繆
缫	繅
缬	纈
缭	繚
缮	繕
缯	繒
缰	纏
缱	繾
缲	纑
缳	纐
缴	纔
缵	纘
罂	罌
罐	鏆
网	緒
罗	羅
罚	羛
罢	羣
罪	辠
罴	羆
羁	羈
羌	羗
羟	羥
群	羣
翅	翄
翘	耼
翻	飜
耀	燿
耔	秄
耕	畊
耢	耮
耧	耬
耨	槈
耸	聳
耻	恥
聂	聶
聃	耼
聋	聾
职	職
聍	聹
联	聯
聩	聵
聪	聰
肃	胏
肇	胐
肛	痠
肠	腸
肤	膚
肮	骯
肯	胓
肴	餻
肾	膇
肿	腫
胀	脹
胁	脅
胆	膽
胚	胹
胜	勝
胧	杤
胨	膌
胪	舊
胫	脛
胭	舉
胶	膠
胸	胷
脍	膾
脏	舓
脐	臍
脑	膞
脓	膿
脔	舕
脶	膖
脸	臉
腊	興
腭	齶
腮	顋
腻	膩
腼	靦
腾	騰
膀	髈
膑	臏
膘	臿
膳	饍
膻	羶
臀	臋
臊	鱢
舆	輿
舍	捨
舣	艤
舰	艦
舱	艙
舵	柁
船	舩
舻	芶
艰	芼
艳	苂
艺	藝
节	節
芗	薵
芜	蕪
芦	蘪
花	蘤
苁	蓯
苇	葦
苈	藶
苋	莧
苌	萶
苍	蒼
苎	苧
苏	蘫
苘	檾
苹	蘯
范	範
茎	莖
茏	蘢
茑	蔦
茔	塴
茕	煢
茜	蒨
茧	纎
茬	茌
荇	莕
草	苃
荚	莢
荛	蕘
荜	蓽
荞	蕎
荟	薱
荠	薺
荡	蕩
荣	榮
荤	葷
荥	滎
荦	犖
荧	熒
荨	蕁
荩	藎
荪	蓀
荫	蔭
荬	蕒
荭	葒
荮	葤
药	藥
莅	涖
莱	萺
莲	蓮
莴	萵
莶	藈
获	獲
莸	蕕
莹	瑩
莺	鴬
莼	蒾
菰	苽
菱	蓤
菹	葅
萝	蘿
萤	螢
营	爄
萦	縨
萧	蕭
萨	薩
萱	萲
萼	蕚
董	蕫
葬	奘
葱	蔥
蒂	蕂
蒇	蕆
蒉	蕢
蒋	蕐
蒌	蕍
蓑	簑
蓝	藍
蓟	薳
蓠	蘺
蓣	蕷
蓥	鎣
蓦	驀
蔹	蘞
蔺	蘟
蔼	藹
蕊	蕋
蕲	蘨
蕴	蘮
薮	藪
薯	藷
藓	蘚
藤	鰧
蘖	櫱
虏	虜
虑	慮
虫	蟲
虬	蚢
虮	蟣
虻	蝱
虽	雖
虾	蝦
虿	蠆
蚀	蝕
蚁	蟻
蚂	螞
蚌	蝝
蚕	衠
蚝	蠔
蚬	蜆
蛇	蚮
蛊	衜
蛎	蠣
蛏	蟶
蛔	蜖
蛮	衭
蛰	蟯
蛱	蛺
蛲	蟯
蛳	螄
蛴	蠐
蜗	蝸
蜡	蠟
蜮	魊
蝇	蠅
蝈	蟲
蝉	蟬
蝎	蠍
蝶	蝖
蝼	蟦
蝾	蠑
螂	蜋
螨	蟎
螺	蠃
蟆	蟱
蟹	蠏
蠢	惷
蠹	衏
衄	衵
衔	銜
补	補
衬	襯
衽	裧
袄	襖
袅	製
袒	襢
袜	襪
袭	襲
袷	奱
装	裝
裆	襠
裉	褃
裙	帬
裝	襲
裢	褳
裣	襝
裤	褲
裥	襪
裴	裵
裸	躶
褓	緥
褴	襤
见	見
观	觀
规	規
觅	覓
视	視
觇	覘
览	覽
觉	觴
觊	觠
觋	覡
觌	覿
觎	觗
觏	觤
觐	觩
觑	觰
觞	觴
觥	觵
触	觸
觯	觶
誉	譽
誊	謄
计	計
订	訂
讣	訃
认	誮
讥	譱
讦	訐
讧	訌
讨	討
让	讓
讪	訕
讫	訖
训	訓
议	議
讯	訊
记	記
讱	訒
讲	講
讳	謒
讴	謳
讵	詎
讶	訝
讷	詆
许	詓
讹	訛
论	論
讻	詋
讼	詀
讽	謘
设	詏
访	詌
诀	詄
证	証
诂	詁
诃	詘
评	評
诅	詛
识	譺
诈	詐
诉	詖
诊	診
诋	詆
诌	謅
词	詞
诎	詘
诏	詔
诐	詖
译	譯
诒	詒
诓	誩
诔	誧
试	試
诖	詿
诗	詩
诘	詰
诙	詼
诚	誠
诛	誨
诜	詵
话	話
诞	誵
诟	詬
诠	詮
诡	詭
询	詢
诣	詣
诤	諍
该	該
详	詳
诧	詫
诨	諢
诩	詡
诫	誡
诬	誣
语	誾
诮	誺
误	誤
诰	誥
诱	誸
诲	誨
诳	課
说	説
诵	誦
诶	誳
请	請
诸	謙
诹	諏
诺	謟
读	讀
诼	諑
诽	誹
课	課
诿	諉
谀	諛
谁	誰
谂	諗
调	調
谄	諂
谅	諒
谆	諄
谇	誶
谈	談
谊	誼
谋	謀
谌	謗
谍	諜
谎	謊
谏	謌
谐	謈
谑	謔
谒	謁
谓	謂
谔	諤
谕	謎
谖	謝
谗	讒
谘	謏
谙	謔
谚	講
谛	謆
谜	謎
谝	諞
谟	謨
谠	讜
谡	謖
谢	謝
谣	謡
谤	謗
谥	謚
谦	謙
谧	謐
谨	謹
谩	謾
谪	謫
谬	謬
谭	譼
谮	譸
谯	譻
谰	讕
谱	譾
谲	議
谳	讞
谴	譴
谵	譫
貌	皃
贝	貝
贞	貞
负	負
贡	貢
财	財
责	責
贤	賢
败	敗
账	賬
货	貨
质	質
贩	販
贪	貪
贫	貧
贬	賖
购	購
贮	賏
贯	貫
贰	賓
贱	賤
贲	賡
贴	賜
贵	賔
贶	賚
贷	賘
贸	賟
费	賛
贺	賠
贻	賝
贼	賊
贽	贄
贾	賨
贿	賤
赀	賒
赁	賣
赂	賢
赃	趎
资	賧
赅	賥
赆	赽
赇	賕
赈	賑
赉	賚
赊	賒
赋	賦
赌	賭
赍	賫
赎	趆
赏	賞
赐	賜
赓	賡
赔	賠
赕	賧
赖	賴
赘	贅
赙	賻
赚	賺
赛	賽
赜	賾
赝	贋
赞	贊
赠	贈
赡	贍
赢	赼
赣	趍
赵	趙
赶	趕
趁	趂
趋	趨
趱	趲
趸	躱
跃	躶
跄	蹌
跖	蹠
跞	躹
践	踐
跷	躤
跸	蹕
跹	躚
跺	踘
跻	躴
踊	踴
踌	躳
踩	踦
踪	蹤
踬	躻
踯	躸
蹄	蹏
蹑	躡
蹒	蹣
蹴	躠
蹶	躡
蹿	躥
躏	躪
躜	躦
躬	躳
躯	軀
躲	躱
车	車
轧	軋
轨	軌
轩	軒
轫	軔
转	辒
轭	軛
轮	輪
软	軟
轰	込
轱	輒
轲	輛
轳	轤
轴	輘
轶	輜
轷	軤
轸	輋
轹	轢
轺	輚
轻	輕
轼	輞
载	載
轾	輊
轿	辤
辁	輇
辂	輅
较	較
辄	輒
辅	輔
辆	輛
辇	輦
辈	輩
辉	輝
辊	輥
辋	輞
辍	輟
辎	輜
辏	輳
辐	輻
辑	輯
输	輸
辔	轡
辕	轅
辖	轄
辗	輾
辘	轪
辙	辢
辚	辭
辞	辭
辣	辢
辩	辯
辫	辮
边	邊
辽	遼
达	達
迁	遷
过	過
迈	邁
运	運
还	還
这	這
进	適
远	遠
违	違
连	遙
迟	遲
迥	逈
迩	邇
迹	踖
适	適
选	選
逊	遜
递	遞
逖	遬
逦	邐
逻	邏
逼	偪
遁	遯
遗	遺
邓	鄧
邝	鄺
邬	鄔
邮	郵
邹	鄒
邺	鄴
邻	鄰
郏	鄍
郐	鄶
郑	鄭
郓	鄆
郦	醔
郧	鄖
郸	鄲
鄹	鄖
酝	醖
酬	詶
酱	醬
酽	釅
酾	釃
酿	釀
醇	醕
采	採
释	釋
里	褃
鉴	鑒
銮	鑾
錾	鐈
钆	釓
钇	釔
针	針
钉	釘
钊	釗
钋	釙
钌	釕
钍	鈗
钎	鈚
钏	鈇
钐	釤
钒	鈉
钓	釣
钔	鍆
钕	鈙
钗	鈕
钙	鈣
钚	鈈
钛	鈦
钜	鋸
钝	鈍
钞	鈔
钟	鐘
钠	鈉
钡	鋇
钢	鋼
钣	鈑
钤	鈐
钥	鑰
钦	歫
钧	鈞
钩	鈎
钪	鈧
钫	鈁
钬	鈥
钭	鈄
钮	鈕
钯	鈠
钰	鈺
钱	鍃
钲	鉦
钳	鉸
钴	鈷
钵	鉢
钶	鈳
钷	鉶
钸	鈽
钹	鈸
钺	鉿
钻	鑽
钼	鉬
钽	鉭
钾	鉀
钿	鈿
铀	鈾
铁	鑖
铃	鈴
铄	鑠
铅	鉼
铆	鉻
铉	鉩
铊	鉨
铋	鉭
铌	鈮
铍	鈹
铎	鑙
铐	鋎
铑	銠
铒	鉺
铕	鋌
铖	鋮
铗	鋏
铘	鋣
铛	鑛
铜	銅
铞	鋒
铟	銦
铠	鎧
铡	鍘
铢	銖
铣	銑
铤	鋌
铥	鋋
铧	鏵
铨	銓
铩	鎩
铪	鉿
铫	銚
铬	鉻
铭	銘
铮	錺
铯	鋍
铰	鉸
铱	銥
铲	鏿
铳	銃
铴	鐋
铵	銨
银	銀
铷	銣
铸	鑤
铹	鐒
铺	鋪
铼	錸
铽	鋱
链	鏈
铿	鏷
销	鋘
锁	鎖
锂	鋰
锃	鋥
锄	鋤
锅	鍋
锆	鋯
锇	鋨
锈	鋚
锉	鋝
锊	鋝
锋	鋒
锌	鋅
锍	鋶
锎	鐦
锏	鐧
锐	鋭
锑	鋜
锒	鋤
锓	鋟
锔	鋦
锕	録
锖	錆
锗	鎛
锘	鍩
错	錯
锚	錨
锛	錻
锝	鍀
锞	錁
锟	錵
锡	錫
锢	錮
锣	鑼
锤	錸
锥	錰
锦	錦
锨	鍁
锩	錈
锪	鍃
锫	錇
锬	鍀
锭	鍁
键	鎖
锯	鋸
锰	錳
锱	錹
锲	鍥
锴	鍇
锵	鏸
锶	鎗
锷	鍔
锸	鍤
锹	鍬
锻	鍛
锼	鎪
锾	鎑
锿	鎥
镀	鍍
镁	鎣
镂	鐄
镄	鐨
镅	鎇
镆	鏌
镇	鎮
镉	鎘
镊	鑷
镌	鐫
镍	鎳
镎	鎿
镏	鎦
镐	鎬
镑	鎊
镒	鎰
镓	鎵
镔	鑌
镖	鐂
镗	鏼
镘	鏽
镜	鐁
镝	鏲
镞	鏃
镡	鐔
镢	鐝
镣	鐐
镤	鏷
镥	鑥
镦	鐓
镧	鑭
镨	鐠
镩	鑹
镪	鏹
镫	鐙
镬	鑪
镭	鑔
镯	鑓
镰	鎌
镱	鑟
镳	鑣
镶	鑲
长	閘
閐	鑮
閒	鎔
間	鏰
閗	鑱
门	閠
闩	関
闪	閣
闭	閉
问	問
闯	阩
闰	閏
闱	闈
闲	閑
闳	閎
间	閒
闵	閔
闶	閌
闷	悶
闸	閘
闹	鬧
闺	閨
闻	聞
闼	陏
闽	閩
闾	閭
阀	閥
阁	閣
阂	阧
阃	閫
阄	鬮
阅	閲
阆	閬
阈	閾
阉	閹
阊	閶
阋	鬩
阌	閿
阍	閽
阎	閻
阏	閼
阐	陁
阑	闌
阒	闃
阔	闊
阕	闋
阖	阧
阗	阣
阙	阨
阚	阹
队	隊
阱	宑
阳	陽
阴	陰
阵	陣
阶	隺
附	坿
际	雋
陆	陸
陇	隴
陈	陳
陉	陘
陕	陝
陡	阧
陨	雃
险	雞
隐	隱
隶	隸
难	難
雇	僱
雏	雛
雕	鵰
雠	讎
雷	靬
雾	靎
霁	靨
霍	靃
霭	靄
靓	靚
面	靣
靥	靨
靴	韞
鞋	韕
鞑	韃
鞒	韝
鞯	韉
鞲	韝
韦	韋
韧	韌
韩	韓
韪	韙
韫	韞
韬	韜
韭	韮
韵	韻
页	頁
顶	頂
顷	頃
顸	頇
项	項
顺	順
须	須
顼	頊
顽	頱
顾	顧
顿	頳
颀	頎
颁	頲
颂	頌
颃	頏
预	頰
颅	颾
领	頸
颇	頷
颈	頸
颉	顁
颊	頰
颌	頼
颍	穎
颏	顆
颐	顄
频	頻
颓	頹
颔	頷
颖	穎
颗	顆
题	題
颚	顎
颛	顓
颜	顔
额	額
颞	飀
颟	顢
颠	顛
颡	顙
颢	顥
颤	顫
颥	顬
颦	颽
颧	飁
风	飈
飑	飏
飒	飐
飓	飠
飕	颼
飘	飄
飙	飆
飚	飈
飞	飛
飧	飱
飨	饗
餐	飱
饥	饑
饧	餳
饨	飩
饩	餼
饪	飪
饫	飫
饬	飭
饭	飯
饮	飲
饯	餿
饰	飾
饱	飽
饲	飼
饴	飴
饵	餯
饶	饒
饷	餫
饺	餃
饼	餅
饽	餲
饿	餴
馁	餳
馄	餼
馅	饂
馆	館
馇	餷
馈	饋
馊	餿
馋	饞
馍	饃
馏	餾
馐	饈
馑	饉
馒	饅
馓	饊
馔	饌
馕	饢
馻	餺
马	駌
驭	駍
驮	駑
驯	駔
驰	駓
驱	驅
驳	駁
驴	骽
驵	駔
驶	駛
驷	駟
驸	駙
驹	駒
驺	騶
驻	駐
驼	駝
驽	駑
驾	駕
驿	骯
骀	駘
骁	驍
骂	駡
骄	驕
骅	驊
骆	駱
骇	駭
骈	駢
骊	髉
骋	騡
验	驗
骏	騟
骐	騯
骑	騮
骒	騭
骓	騥
骖	驂
骗	騙
骘	騭
骚	騷
骛	騖
骜	驁
骝	騮
骞	騫
骟	騸
骠	驃
骡	騾
骢	驄
骤	骵
骥	髃
骧	骿
骴	髊
骼	胕
髂	胳
髅	髏
髋	髖
髌	髕
髏	髊
髡	髨
髭	頾
髯	髥
鬃	鬭
鬓	魒
魅	鬽
魇	魘
魉	魎
鱼	魚
鱿	魷
鲁	魯
鲂	魴
鲅	鮡
鲆	鮣
鲇	鮮
鲈	鱸
鲋	鮲
鲌	鮪
鲍	鮱
鲎	鱟
鲐	鮰
鲑	鮭
鲒	鮚
鲔	鮪
鲕	鮞
鲚	鱭
鲛	鮫
鲜	鮮
鲞	鮝
鲟	鱘
鲠	鯁
鲡	鱺
鲢	鰱
鲣	鰹
鲤	鯉
鲦	鰷
鲧	鯀
鲨	鯊
鲩	鯇
鲫	鯽
鲭	鯖
鲮	鰊
鲰	鰋
鲱	鰁
鲲	鰄
鲳	鰇
鲴	鯽
鲵	鰂
鲷	鯛
鲸	鰈
鲻	鯔
鲼	鱝
鲽	鰈
鲾	鰏
鳃	鰓
鳄	鰐
鳅	鰍
鳆	鰒
鳇	鰉
鳊	鯿
鳌	鰲
鳍	鰭
鳎	鰨
鳏	鰥
鳐	鰩
鳔	鱞
鳕	鱨
鳖	鱩
鳗	鰻
鳘	鰵
鳙	鱥
鳜	鱶
鳝	鱴
鳞	鱗
鳟	鱲
鳢	鱧
鳣	鱣
鸟	鴅
鸠	鴉
鸡	鶏
鸢	鴖
鸣	鴔
鸥	鷗
鸦	鴉
鸧	鷌
鸨	鴇
鸩	鴆
鸪	鴣
鸫	鶇
鸬	鹯
鸭	鴨
鸯	鴦
鸱	鴟
鸲	鴝
鸳	鴛
鸵	鴕
鸶	鷥
鸷	鷙
鸸	鴯
鸹	鴰
鸺	鵂
鸽	鴿
鸾	鸞
鸿	鴻
鹁	鵳
鹂	鹺
鹃	鵱
鹄	鵠
鹅	鵽
鹆	鵲
鹇	鷳
鹈	鵼
鹉	鵡
鹊	鵲
鹋	鶓
鹌	鵪
鹎	鵯
鹏	鵬
鹑	鶉
鹗	鶚
鹘	鷛
鹚	鷀
鹛	鷅
鹜	騖
鹞	鷂
鹣	鷜
鹤	鷔
鹦	鹷
鹧	鷓
鹨	鷚
鹩	鷯
鹪	鷦
鹫	鷲
鹬	鷸
鹭	鷺
鹱	鷛
鹳	鹸
鹾	鹺
麇	麕
麟	麐
麦	麥
麸	麩
黉	鼁
默	嘿
黛	黱
黥	剠
黩	黷
黪	黲
黾	黽
鼋	黿
鼌	鼂
鼍	鼉
鼓	皷
鼹	齜
齐	齬
齑	韲
齩	皻
齿	齲
龀	齴
龃	齟
龄	齡
龅	齙
龆	齠
龇	齜
龈	齦
龉	齬
龊	齪
龋	齲
龌	齷
龙	龍
龛	龕
龟	龜
