乗	乘
乫	世
乲	并
亂	乱
亙	亘
亞	亚
亱	夜
亷	廉
佀	似
佇	伫
佪	徊
來	来
侖	仑
俠	侠
俥	伡
俲	效
俽	欣
倀	伥
倆	俩
倉	仓
個	个
們	们
倣	仿彷
倫	伦
倸	睬
偉	伟
偪	逼
側	侧
偵	侦
偽	伪
傑	杰
傓	煽
傖	伧
傘	伞
備	备
傭	佣
傯	偬
傳	传
傴	伛
債	债
傷	伤
僡	惠倾
僥	偻侥
僨	偾
僪	仅
僱	雇佥
僲	仙
價	价
僺	侨
僿	仆塞
儀	仪
儁	俊
儂	侬
億	亿
儈	侩
儉	俭
儍	傻
儐	傧
儔	俦
儕	侪
儗	拟
儘	尽
償	倘
優	优
儲	储
儷	俪
儺	傩
儻	傥
儼	俨
儽	傫
兎	兔
兒	儿
兠	兜
兩	两
冄	冉
冐	冒
冩	写
凈	净
凍	冻
刪	删
刴	剁
刼	劫
刾	凯
剄	刭
剅	凭
則	则
剈	刃
剋	克
剗	刬
剛	刚
剠	黥
剮	剐
剴	剀
創	创
剹	戮
劇	剧
劉	刘
劊	刽
劌	刿
劍	剑
劑	剂
勁	劲
勅	敕
勌	倦
動	动
勗	勖
務	务
勛	勋
勝	胜
勞	劳
勡	剽
勢	势
勦	剿
勱	劢
勵	励
勸	劝
匃	丐
匮	柜
區	区
協	协
卲	劭
卶	匦
卹	汇恤
卼	匮
厙	厍
厭	厌
厲	厉
厴	厣
參	参叁
収	收
叚	假徦
叡	睿
叢	丛
吚	咿
吢	吣
呝	呃
呪	咒
咊	和
哶	咩
唀	侉
唄	呗
唕	唣
唗	员
唫	吟
問	问
啑	喋
啓	启
啗	啖
啞	哑
喆	哲
喒	咱
喪	丧
喫	吃
喬	乔
單	单
喲	哟
喿	噪
嗁	啼
嗆	呛
嗇	啬
嗎	吗
嗚	呜
嗩	唢
嗶	哔
嘆	叹
嘰	叽
嘵	哓
嘾	喽
嘿	默
噁	呼
噄	呕
噆	啧
噇	尝
噊	唛
噑	嗥
噕	啸
噖	哗
噛	啮
噝	唠咝
噠	哒
噥	哝
噦	哕
噯	嗳
噲	哙
噴	喷
噸	吨
嚀	咛
嚇	吓
嚌	哜
嚕	噜
嚦	呖
嚨	咙
嚳	喾
嚴	严
嚶	嘤
嚻	嚣
囀	啭
囁	嗫
囅	冁
囈	呓
囑	嘱
圅	函
圇	囵
國	国
圌	篅
圍	围
園	园
坅	圆
坉	图
坒	团
坿	附
垜	垛
埡	垭
執	执
堃	坤
堅	坚
堖	垴
堘	塍
堝	埚
堯	尧
報	报
場	场
塤	埙
塳	块
塴	茔
塵	尘
塶	垲
塹	堑
塿	冢
墊	垫
墖	塔
墜	坠
墪	墩
墮	堕
墳	坟
墾	垦
壆	学
壇	坛
壓	压
壘	垒
壙	圹
壚	垆
壞	坏
壟	垄
壢	坜
壩	坝
壯	壮
壺	壶
壻	婿
壼	壸
壽	寿
夘	卯
夢	梦
夥	伙
奘	葬
奮	奋
奱	袷夹
妀	奂
妜	奖
妝	奁妆
妟	夺
妬	妒
妳	你
姉	姊
姍	姗
姙	妊
姦	奸
姪	侄
姸	妍
婁	娄
媋	姻
媎	妇
媔	娅
媢	偷
媧	娲
媽	妈
嫗	妪
嫵	妩
嫻	娴
嬀	妫
嬈	娆
嬋	婵
嬌	娇
嬡	嫒
嬪	嫔
嬭	奶
嬰	婴
嬸	婶
孃	娘
孿	孪
宑	阱
宒	恋娈
宱	孙
寃	冤
寊	孽
寍	宁
寢	寝
實	实
審	审
寬	宽
寰	宪
寳	宝
寵	宠
將	将
專	专
尋	寻
對	对
導	导
尷	尴
屜	屉
層	层
屨	屦
屬	属
岡	冈
峩	峨
峯	峰
峴	岘
島	岛
峽	峡
崍	崃
崕	崖
崗	岗
崧	嵩
嵐	岚
嵠	溪
嶁	嵝
嶄	崭
嶇	岖
嶔	嵚
嶗	崂
嶠	峤
嶽	岳
巀	截
巉	峄
巋	岿
巒	峦
巓	巅
巖	岩
巗	岙
巚	嵘
巟	岭
巣	屿
巰	巯
巵	卮
帀	匝
帥	帅
師	师
帬	裙
帳	帐
帶	带
幃	帏
幗	帼
幘	帻
幙	幕
幟	帜
幣	币
幫	帮
幬	帱
庫	库
庻	庶
廁	厕
廄	厩
廬	庐
廳	厅
廵	巡
廼	乃
弉	厨
弐	庙
弒	厂
弔	吊庑怃
弖	废
弙	广
弳	弪
張	张
強	强
彈	弹
彌	弥
彎	弯
彜	彝
徑	径
従	从
徠	徕
復	复
徹	彻
忼	慷
怺	恿
恆	恒
恠	匆怪
恡	吝
恥	耻恍
悵	怅
悶	闷
惏	婪
惡	垩恶
惪	德
惲	恽
惷	蠢
惻	恻
愙	恪
愛	爱
愜	惬
愨	悫
愴	怆
愷	恺
愾	忾
慮	虑
慳	悭
慴	慑态
慶	庆
慾	欲
慿	惨
憁	惭
憂	忧
憅	恸
憇	憩
憈	惯
憊	惫
憏	怄
憐	怜怂
憒	愦
憚	惮
憜	惰
憞	憝
憤	愤
憫	悯
憶	忆
懇	恳
應	应
懌	怿
懟	怼
懣	懑
懲	惩
懶	懒
懷	怀
懸	悬
懺	忏
懼	惧
戔	戋
戞	戛
戧	戗
戩	戬
戰	战
戲	戏
戹	厄
抜	捍
拓	摭
拕	拖
挱	挲
挾	挟
挿	插
捄	救
捨	舍
捫	扪
捵	抻
掃	扫
掄	抡
掛	挂
採	采
揀	拣
揫	揪
揮	挥
搃	捏
損	损扬
搗	捣
搤	扼
搥	捶
搧	扇
搶	抢
摀	捂
摃	扛
摑	掴
摜	掼
摟	搂
摣	揸
摳	抠
摶	抟
摺	折
摻	掺
撃	击
撈	捞
撓	挠
撟	挢
撡	操
撣	掸
撥	拨
撦	扯
撲	扑
撳	揿
撹	搅
撻	挞
撾	挝
撿	捡检
擁	拥
擄	掳
擇	择
擋	挡
擔	担
據	据
擺	摆
擻	擞
擼	撸
擾	扰
攄	挤摅
攅	抬攒
攆	撵
攏	拢
攑	摈
攓	拧
攔	搁拦
攕	掷
攖	撄
攗	扩
攙	搀
攛	撺撷
攜	携
攝	摄
攡	摛
攣	挛
攤	摊
攬	揽
敂	叩
敗	败
敘	叙
敵	敌
數	数
斂	敛
斃	毙
斎	斋
斕	斓
斬	斩
斷	断
斻	杭
昬	昏
時	时
晉	晋
晝	昼
晳	晰
暁	晓
暈	晕
暉	晖
暎	映
暘	昫
暢	畅
暫	暂
暱	昵
曄	晔
曇	昙
曖	暧
曠	旷
曡	叠
曬	晒
書	书
會	会
朶	朵
杇	圬
杛	望
杤	胧
東	东
枏	楠
枴	拐
柁	舵
柹	柿
栢	柏
栰	筏
梔	栀
梘	杯枧
條	条
梟	枭
梡	柳
棃	梨
棄	弃
棖	枨
棗	枣
棟	栋
棧	栈
棲	栖
棹	桌
椏	桠
椶	棕
楊	杨
楓	枫
榗	楦
榘	矩
榚	桢
榠	业
榤	梅
榦	极
榪	杩
榮	荣
榿	桤
槀	槁
槈	耨
構	构
槍	枪
槓	杠
様	样
槧	椠
槨	椁
槩	概
槳	桨
樁	桩
樂	乐
樅	枞
樑	梁
樓	楼
標	标
樝	楂
樞	枢
権	权
樹	树
樺	桦
橈	桡
橋	桥
橕	撑
橜	橛
檆	机
檉	柽
檔	档
檜	桧
檣	樯
檮	梼
檳	槟
檸	柠
檻	槛
檾	苘
櫂	棹
櫈	凳
櫓	橹
櫛	栉
櫝	椟
櫞	橼
櫟	栎
櫧	槠
櫨	栌
櫪	枥
櫬	榇
櫱	蘖
櫳	栊
櫸	榉
櫻	樱
欄	栏
欏	椤
欒	栾
欖	榄
歟	款欤
歡	欢
歫	钦
歲	岁
歷	历
歸	归
殘	残
殞	殒
殤	殇
殫	殚
殭	僵
殮	殓
殯	殡
殲	歼
殺	杀
殻	壳
毆	殴
毿	毵
氊	毡
氌	氇
氣	气
氫	氢
氬	氩
汙	污
沲	沱
況	况
泎	冱
泝	溯
洩	泄
洶	汹
浹	浃
涇	泾
涖	莅
涙	泪
淺	浅
渄	凄
渟	沦
渢	沨
測	测渊
渮	涞
渾	浑
湞	浈
湧	涌
湯	汤
湻	淳
溈	沩
溝	沟
滄	沧
滅	灭
滌	涤
滎	荥
滛	淫
滬	沪
滯	滞
漚	沤
漛	渗
漟	卤
漡	浒
漣	浐涟
漨	满
漬	渍
漮	渔
漲	涨
漸	渐
漿	浆
潄	漱
潑	泼
潔	洁
潛	潜
潤	润
潯	浔
潰	溃
潿	涠
澀	涩
澂	澄
澆	浇
澇	涝
澐	泇
澗	涧
澘	潸
澣	浣
澤	泽
澩	泶
澮	浍
濁	浊
濃	浓
濄	涡
濕	湿
濘	泞
濟	济
濤	涛
瀅	滢
瀆	渎
瀉	泻
瀍	滥
瀎	浚
瀏	浏
瀐	潍
瀒	滨
瀕	濒
瀘	泸
瀝	溅沥
瀟	泺潇
瀠	潆
瀧	泷
瀨	濑
瀲	潋
瀾	澜
灃	沣
灄	滠
灋	法
灑	洒
灔	滟
灕	漓
灘	滩
灝	灏
灣	湾
灤	滦
災	灾
炤	照昭
為	为
烏	乌
焝	炯
焠	烃
無	无
煉	炼
煑	煮
煒	炜
煖	暖
煙	烟
煠	炸
煢	茕
煩	烦
煬	炀
熈	熙
熒	荧
熗	炝
熱	热
熺	熹
熾	炽
燁	烨
燄	焰
燈	灯
燉	炖
燐	磷
燒	烧
燼	烬
燾	烫焘
燿	耀
爁	焖
爄	营
爊	灿
爋	曦
爍	烁
爐	炉烛
爕	燮
爖	烩
爛	烂
爭	争
爺	爷
爾	尔
牀	床
牘	牍
牽	牵
犂	犁
犖	荦
犛	牦
犢	犊
犧	牺
狀	状
猨	猿
猰	狭
猲	狈
猶	犹
猺	悍
猻	狲
獁	犸
獃	呆
獄	狱
獅	狮
獧	狷
獨	独
獪	狯
獫	猃
獰	狞
獲	获
玞	猎
玡	犷
玣	兽
玥	獭
玦	献
玧	猕
玨	珏
玪	猱
玬	猡
玵	妙
珎	珍
珪	圭
珮	佩
琭	现
琹	琴
琺	珐
琾	璃
琿	珲
瑋	玮
瑒	玚
瑠	琉
瑣	琐
瑩	莹
瑪	玛
瑯	琅
璡	琿
璣	玑
璦	瑷
璬	琪
環	环
璱	琏
璵	玙
璽	玺
璿	璇
瓊	琼
瓌	瑰
瓏	珑
瓔	璎
瓚	瓒
甛	甜
産	产
畁	瓷
畉	欧瓯
畊	耕
畝	亩
畢	毕
畧	略
畫	画
異	异
畱	留
當	当
畺	疆
疇	畴
痙	痉
痚	疏
痠	肛
瘉	愈
瘋	疯
瘍	疡
瘡	疮
瘧	疟
瘻	瘘
療	疗
癅	瘤
癧	疬
癩	癞
癬	癣
癭	瘿
癮	痨瘾
癰	痫痈
癱	瘫
癲	瘅癫
發	发
皁	疠皂
皃	貌
皌	瘪
皏	痴
皐	皋痒
皒	疖
皔	症
皚	皑
皰	疱
皷	鼓
皸	皲
皺	皱
皻	齩
盿	盍
眐	盏
眔	监
眕	盘
眗	卢
眥	眦
瞇	眯
瞐	睐
瞑	眠
瞔	眷
瞘	眍
瞞	瞒
瞪	瞠
瞼	睑
矁	瞅
矚	瞩
矦	侯
砤	砣
砪	矫
砱	碇
硤	硖
硨	砗
硯	砚
碸	砜
確	确
碼	码
磖	砬
磘	硕
磚	砧砖
磝	砀
磣	碜
磧	碛
磯	矶
磽	硗
礫	砾
礬	矾
礱	础砻
祂	碍
祇	祗
祐	矿
祑	擂
祕	砺
禍	祸
禎	祯
禰	祢
禱	祷
禸	祎
秄	耔
秈	籼
秌	秋
秏	祃
秛	禅
秠	礼
稈	秆
穅	糠
穉	稚
穌	稣
穎	颍颖
穖	秸
穘	种
穛	称
穡	穑
穢	稿秽
穤	糯
穩	稳
窓	窗
窛	筘
竅	窍
竇	窦
竈	灶
竊	窃
竎	窝
竑	穷
竒	窑
竚	窭
竡	窥
竪	竖
竮	窜
競	竞
竾	篪
筧	笕
筩	筒
筯	箸
筽	笔
箂	笋
箊	策
箋	笺
箠	棰
箲	筅
節	节
範	范
篲	彗
篳	筚
篵	筑
簀	箦
簈	涅
簍	篓
簐	笃
簑	蓑
簓	筛
簞	箪
簡	简
簣	篑
簫	箫
簮	簪
簷	檐
簽	签
簾	帘
籃	篮
籟	籁
籠	笼
籩	笾
籪	簖
籬	篱
籭	筹
籮	箩
粁	箨
粃	秕
粇	粳
粰	稃
粺	稗
糲	粝
糴	籴
糵	粽
糶	粜
糾	纠
紀	纪
紂	纣
紃	糁
約	粪约
紅	红糨
紆	纡
紇	纥
紈	纨
紉	纫
紋	纹
紌	粮
納	纳
紐	纽
紓	纾
純	纯
紗	纱
紙	纸
級	级
紛	纷
紜	纭
紡	纺
紥	扎
細	细
紱	绂
紲	绁
紳	绅
絙	绍
絚	绀
絜	绋
絝	绔
絞	绞
絟	绐
絠	绌
絢	绚终
絣	弦
絤	组
給	绊给
絨	绒
絯	绗
統	结统
絲	丝
絳	绛
絶	绝
絹	绢
綁	绑
綃	绡
綈	绨
綉	绣
綏	绥
綑	捆
經	经
綸	纶
綹	绺
綺	绮
綻	绽
綽	绰
綾	绫综
綿	绵
緄	绸
緅	绻
緇	綦缁
緊	紧
緋	绯
緌	线
緍	绶
緎	维
緐	绾
緑	纲绿
緒	网绪
緓	绷
緔	绱缀
緗	缃
緙	缂
線	缐
緝	缉
緞	缎
締	缔
緡	缗
緣	缘
緥	褓
緦	缌
編	编
緩	缓
緬	缅
緯	纬
緱	缑
緲	缈
練	练
緶	缏
緹	缇
縛	缚
縜	缊
縝	缜
縟	缛
縣	县
縧	绦
縨	萦
縩	缙
縪	缢
縫	缝缒
縭	缡
縮	缩
縰	绉
縱	缣纵
縲	缧
縴	纤
縵	缦
縶	絷
縷	缕
縹	缥
總	总
績	绩
繅	缫
繆	缪
繋	系
繒	缯
織	织
繕	缮
繚	缭
繞	绕
繹	绎
繼	继
繽	缤
繾	缱
纃	缋
纈	缬
纊	纩绳
纋	绘
續	续
纍	累
纎	茧
纏	缠缰
纐	缳
纑	缲
纓	缨
纔	缴
纘	缵
纜	缆
缾	瓶
罇	樽
罋	瓮
罌	罂
羅	罗
羆	罴
羈	羁
羗	羌
羛	罚
羣	罢群
羥	羟
義	义
羶	膻
翄	翅
習	习
耬	耧
耮	耢
耼	聃翘
聖	圣
聞	闻
聯	联
聰	聪
聲	声
聳	耸
聵	聩
聶	聂
職	职
聹	聍凝
聽	听
聾	聋
胏	肃
胐	肇
胓	肯
胕	骼
胳	髂
胷	胸
胹	胚
胾	疣
脀	吻
脅	胁
脛	胫
脣	唇
脹	胀
腫	肿
腸	肠
膇	肾
膌	胨
膖	脶
膚	肤
膞	脑
膠	胶
膩	腻
膽	胆
膾	脍
膿	脓
臉	脸
臋	臀
臍	脐
臏	膑
臿	膘
與	与
興	腊兴
舉	举胭
舊	旧胪
舓	脏
舕	脔
舙	卧
舝	临
舩	船
艙	舱
艤	舣
艦	舰
芶	舻
芻	刍
芼	艰
苂	艳
苃	草
苧	苎
苽	菰
茌	茬
莊	庄
莕	荇
莖	茎
莢	荚
莧	苋
萢	华
萬	万
萲	萱
萵	春莴
萶	苌
萺	莱
葅	菹
葉	叶
葒	荭
葤	荮
葦	苇
葷	荤
蒨	茜
蒻	箬
蒼	苍
蒾	莼
蓀	荪
蓆	席
蓋	盖
蓤	菱
蓮	莲
蓯	苁
蓽	荜
蔥	葱
蔦	茑
蔭	荫
蕁	卜荨
蕂	蒂
蕆	蒇
蕋	蕊
蕍	蒌
蕎	荞
蕐	蒋
蕒	荬
蕕	莸
蕘	荛
蕚	萼
蕢	蒉
蕩	荡
蕪	芜
蕫	董
蕭	萧
蕱	筲
蕷	蓣
薩	萨
薱	荟
薳	蓟
薵	芗
薺	荠
藈	莶
藍	蓝
藎	荩
藝	艺
藥	药
藪	薮
藶	苈
藷	薯
藹	蔼
蘚	藓
蘞	蔹
蘟	蔺
蘢	茏
蘤	花
蘨	蕲
蘪	芦糜
蘫	苏
蘭	兰
蘮	蕴
蘯	苹
蘺	蓠
蘿	萝
處	处
虜	虏
號	号
虧	亏
蚢	虬
蚮	蛇
蛂	刖
蛺	蛱
蜆	蚬
蜋	螂
蜖	蛔
蝕	蚀
蝖	蝶
蝝	蚌
蝟	猬
蝦	虾
蝱	虻
蝸	蜗
螄	蛳
螞	蚂
螢	萤
蟎	螨
蟣	虮
蟦	蝼
蟬	蝉
蟯	蛲蛰
蟱	蟆
蟲	虫蝈
蟶	蛏
蟻	蚁
蠃	螺
蠅	蝇
蠆	虿
蠍	蝎
蠏	蟹
蠐	蛴
蠑	蝾
蠔	蚝
蠟	蜡
蠣	蛎
衆	众
衏	蠹
術	术
衛	卫
衜	蛊
衝	冲
衠	蚕
衭	蛮
衵	衄
袟	帙
裘	求
補	补
裝	装
裧	衽
裵	裴
製	袅
褃	裉里
褲	裤
褳	裢
襖	袄
襝	裣亵
襠	裆
襢	袒
襤	褴
襩	幞
襪	裥袜
襯	衬
襲	裝袭
見	见
覍	弁
規	规
覓	觅
視	视
覘	觇
覡	觋
覽	览
覿	觌
觀	观
觗	觎
觛	睹
觝	亲
觠	觊
觤	觏
觩	觐
觰	觑
觴	觉觞
觵	觥
觶	觯
觸	触
訂	订
訃	讣
計	计
訊	讯
訌	讧
討	讨
訐	讦
訒	讱
訓	训
訕	讪
訖	讫
記	记
訛	讹
訝	讶
診	诊
証	证
詀	讼
詁	诂
詄	诀
詆	诋讷
詋	讻
詌	访
詎	讵
詏	设
詐	诈
詒	诒
詓	许
詔	诏
評	评
詖	诐诉
詘	诃诎
詛	诅
詞	词
詠	咏
詡	诩
詢	询
詣	诣
試	试
詧	察
詩	诗
詫	诧
詬	诟
詭	诡
詮	诠
詰	诘
話	话
該	该
詳	详
詵	诜
詶	酬
詼	诙
詿	诖
誠	诚
誡	诫
誣	诬
誤	误
誥	诰
誦	诵
誧	诔
誨	诲诛
誩	诓
説	说
誮	认
誰	谁
課	课诳
誳	诶
誵	诞
誶	谇
誸	诱
誹	诽
誺	诮
誼	谊
誾	语
調	调
諂	谄
諄	谆
談	谈
諉	诿
請	请
諍	诤
諏	诹
諑	诼
諒	谅
論	论
諗	谂
諛	谀
諜	谍
諞	谝
諢	诨
諤	谔
謀	谋
謁	谒
謂	谓
謄	誊
謅	诌
謆	谛
謈	谐
謊	谎
謌	歌谏
謎	谜谕
謏	谘
謐	谧
謒	讳
謔	谙谑
謖	谡
謗	谤谌
謘	讽
謙	谦诸
謚	谥
講	讲谚
謝	谢谖
謟	诺
謡	谣
謨	谟
謫	谪
謬	谬
謳	讴
謹	谨
謾	谩
謿	嘲
譆	嘻
譫	谵
譯	译
議	谲议
譱	讥
譴	谴
護	护
譸	谮
譺	识
譻	谯
譼	谭
譽	誉
譾	谱
讀	读
變	变
讌	宴
讎	仇雠
讒	谗
讓	让
讕	谰
讜	谠
讞	谳
豰	岂
豷	丰
貓	猫
貛	獾
貝	贝
貞	贞
負	负
財	财
貢	贡
貧	贫
貨	货
販	贩
貪	贪
貫	贯
責	责
賊	贼
賏	贮
賑	赈
賒	赊赀
賓	宾贰
賔	贵
賕	赇
賖	贬
賗	买
賘	贷
賚	贶赉
賛	费
賜	赐贴
賝	贻
賞	赏
賟	贸
賠	贺赔
賡	贲赓
賢	赂贤
賣	赁卖
賤	贿贱
賥	赅
賦	赋
賧	赕资
賨	贾
質	质
賫	赍
賬	账
賭	赌
賴	赖
賺	赚
賻	赙
購	购
賽	赛
賾	赜
贄	贽
贅	赘
贈	赠
贊	赞
贋	赝
贍	赡
赼	赢
赽	赆
趂	趁
趆	赎
趍	赣
趎	赃
趕	赶
趙	赵
趨	趋
趲	趱
踐	践
踖	迹
踘	跺
踦	踩
踴	踊
蹌	跄
蹏	蹄
蹕	跸
蹠	跖
蹣	蹒
蹤	踪
躚	跹
躠	蹴
躡	蹶蹑
躤	跷
躥	蹿
躦	躜
躪	躏
躱	趸躲
躳	踌躬
躴	跻
躶	裸跃
躸	踯
躹	跞
躻	踬
軀	躯
軆	体
車	车
軋	轧
軌	轨
軍	军
軒	轩
軔	轫
軛	轭
軟	软
軤	轷
較	较
輅	辂
輇	辁
載	载
輊	轾
輋	轸
輒	轱辄
輓	挽
輔	辅
輕	轻
輘	轴
輚	轺
輛	轲辆
輜	轶辎
輝	辉
輞	轼辋
輟	辍
輥	辊
輦	辇
輩	辈
輪	轮
輯	辑
輳	辏
輸	输
輻	辐
輾	辗
輿	舆
轂	毂
轄	辖
轅	辕
轡	辔
轢	轹
轤	轳
轪	辘
辒	转
辠	罪
辢	辣辙
辤	轿
辦	办
辭	辞辚
辮	辫
辯	辩
農	农
込	轰
迴	回
逈	迥
這	这
運	运
過	过
達	达
違	违
遙	连
遜	逊
遞	递
遠	远
適	进适
遬	逖
遯	遁
遲	迟
遷	迁
選	选
遺	遗
遼	辽
邁	迈
還	还
邇	迩
邊	边
邏	逻
邐	逦
邨	村
郵	邮
鄆	郓
鄉	乡
鄍	郏
鄒	邹
鄔	邬
鄖	郧鄹
鄧	邓
鄭	郑
鄰	邻
鄲	郸
鄴	邺
鄶	郐
鄺	邝
醔	郦
醕	醇
醖	酝
醜	丑
醫	医
醬	酱
釀	酿
釃	酾
釅	酽
釋	释
釐	厘
釓	钆
釔	钇
釕	钌
釗	钊
釘	钉
釙	钋
針	针
釣	钓
釤	钐
鈁	钫
鈄	钭
鈇	钏
鈈	钚
鈉	钒钠
鈍	钝
鈎	钩
鈐	钤
鈑	钣
鈔	钞
鈕	钗钮
鈗	钍
鈙	钕
鈚	钎
鈞	钧
鈠	钯
鈣	钙
鈥	钬
鈦	钛
鈧	钪
鈮	铌
鈳	钶
鈴	铃
鈷	钴
鈸	钹
鈹	铍
鈺	钰
鈽	钸
鈾	铀
鈿	钿
鉀	钾
鉢	钵
鉦	钲
鉨	铊
鉩	铉
鉫	刨
鉬	钼
鉭	铋钽
鉶	钷
鉸	铰钳
鉺	铒
鉻	铬铆
鉼	铅
鉿	铪钺
銀	银
銃	铳
銅	铜
銑	铣
銓	铨
銖	铢
銘	铭
銚	铫
銜	衔
銠	铑
銣	铷
銥	铱
銦	铟
銨	铵
鋅	锌
鋇	钡
鋋	铥
鋌	铤铕
鋍	铯
鋎	铐
鋏	铗
鋒	铞锋
鋓	焊
鋘	销
鋚	锈
鋜	锑
鋝	锉锊
鋟	汞锓
鋣	铘
鋤	锄锒
鋥	锃
鋦	锔
鋨	锇
鋪	铺
鋭	锐
鋮	铖
鋯	锆
鋰	锂
鋱	铽
鋶	锍
鋸	锯钜
鋼	钢
錁	锞
錆	锖
錇	锫
錈	锩
錦	锦
錨	锚
錫	锡
錮	锢
錯	错
錰	锥
録	锕录
錳	锰
錵	锟
錸	锤铼
錹	锱
錺	铮
錻	锛
鍀	锝锬
鍁	锭锨
鍃	锪钱
鍆	钔
鍇	锴
鍋	锅
鍍	镀
鍔	锷
鍘	铡
鍛	锻
鍤	锸
鍥	锲
鍩	锘
鍬	锹
鎇	镅
鎊	镑
鎌	镰
鎑	锾
鎔	熔閒
鎕	糖
鎖	键锁
鎗	锶
鎘	镉
鎛	锗
鎣	镁蓥
鎥	锿
鎦	镏
鎧	铠
鎩	铩
鎪	锼
鎬	镐
鎮	镇
鎰	镒
鎳	镍
鎵	镓
鎿	镎
鏃	镞
鏆	罐
鏇	旋
鏈	链
鏌	镆
鏰	間
鏲	镝
鏵	铧
鏷	铿镤
鏸	锵
鏹	镪
鏼	镗
鏽	镘
鏿	铲
鐁	镜
鐂	镖
鐄	镂
鐈	錾
鐋	铴
鐐	镣
鐒	铹
鐓	镦
鐔	镡
鐘	钟
鐙	镫
鐝	镢
鐠	镨
鐦	锎
鐧	锏
鐨	镄
鐫	镌
鑌	镔
鑒	鉴
鑓	镯
鑔	镭
鑖	铁
鑙	铎
鑛	铛
鑟	镱
鑠	铄
鑣	镳
鑤	铸
鑥	镥
鑪	镬
鑭	镧
鑮	閐
鑰	钥
鑱	閗
鑲	镶
鑷	镊
鑹	镩
鑼	锣
鑽	钻
鑾	銮
鑿	凿
閉	闭
開	开
閌	闶
閎	闳
閏	闰
閑	闲
閒	间
閔	闵
閘	长闸
閠	门
関	闩
閣	阁闪
閥	阀
閨	闺
閩	闽
閫	阃
閬	阆
閭	闾
閲	阅
閶	阊
閹	阉
閻	阎
閼	阏
閽	阍
閾	阈
閿	阌
闃	阒
闈	闱
闊	阔
闋	阕
闌	阑
阣	阗
阧	陡阂阖
阨	阙
阩	闯
阯	址
阷	关
阸	嫖
阹	阚
陁	阐
陏	闼
陘	陉
陝	陕
陣	阵
陰	阴
陳	陈
陸	陆
陻	堙
陽	阳
隄	堤
隊	队
隱	隐
隴	陇
隸	隶
隺	阶
隻	只
雃	陨
雋	际
雖	虽
雙	双
雛	雏
雜	杂
雞	险
離	离
難	难
雰	氛
雲	云
電	电
靃	霍
靄	霭
靈	灵
靉	叆
靎	雾
靚	靓
靣	面
靦	腼
靨	霁靥
靬	雷
鞏	巩
韃	鞑
韉	鞯
韋	韦
韌	韧
韓	韩
韕	鞋
韙	韪
韜	韬
韝	鞲鞒
韞	靴韫
韮	韭
韲	齑
韻	韵
響	响
頁	页
頂	顶
頃	顷
項	项
順	顺
頇	顸
須	须
頊	顼
頌	颂
頎	颀
頏	颃
頫	俯
頭	头
頰	颊预
頱	顽
頲	颁
頳	顿
頷	颔颇
頸	颈领
頹	颓
頻	频
頼	颌
頾	髭
顁	颉
顄	颐
顆	颗颏
顋	腮
題	题
額	额
顎	颚
顓	颛
顔	颜
顙	颡
顛	颠
類	类
顢	颟
顥	颢
顦	憔
顧	顾
顫	颤
顬	颥
顯	显
颼	飕
颽	颦
颾	颅
飀	颞
飁	颧
飄	飘
飆	飙
飈	飚风
飏	飑
飐	飒
飛	飞
飜	翻
飠	飓
飩	饨
飪	饪
飫	饫
飭	饬
飯	饭
飱	餐飧
飲	饮
飴	饴
飼	饲
飽	饱
飾	饰
餃	饺
餅	饼
餈	糍
餧	喂
館	馆
餫	饷
餬	养
餯	饵
餱	糇
餲	饽
餳	馁饧
餴	饿
餷	馇
餺	馻
餻	糕肴
餼	馄饩
餾	馏
餿	饯馊
饂	馅
饃	馍
饅	馒
饈	馐
饉	馑
饊	馓
饋	馈
饌	馔
饍	膳
饑	饥
饒	饶
饗	飨
饞	馋
饢	馕
駁	驳
駌	马
駍	驭
駎	冯
駐	驻
駑	驽驮
駒	驹
駓	驰
駔	驯驵
駕	驾
駘	骀
駙	驸
駛	驶
駝	驼
駟	驷
駡	骂
駢	骈
駭	骇
駱	骆
騖	骛鹜
騙	骗
騟	骏
騡	骋
騥	骓
騫	骞
騭	骒骘
騮	骝骑
騯	骐
騰	腾
騶	驺
騷	骚
騸	骟
騾	骡
驀	蓦
驁	骜
驂	骖
驃	骠
驄	骢
驅	驱
驊	骅
驍	骁
驕	骄
驗	验
驚	惊
骯	肮驿
骵	骤
骽	驴
骿	骧
髃	骥
髈	膀
髉	骊
髊	髏骴
髏	髅
髕	髌
髖	髋
髥	髯
髨	髡
髰	剃
鬆	松
鬧	闹
鬩	阋
鬭	鬃
鬮	阄
鬽	魅
魊	蜮
魎	魉
魒	鬓
魕	斗
魘	魇
魚	鱼
魯	鲁
魴	鲂
魷	鱿
鮚	鲒
鮝	鲞
鮞	鲕
鮡	鲅
鮣	鲆
鮪	鲌鲔
鮫	鲛
鮭	鲑
鮮	鲇鲜
鮰	鲐
鮱	鲍
鮲	鲋
鯀	鲧
鯁	鲠
鯇	鲩
鯉	鲤
鯊	鲨
鯔	鲻
鯖	鲭
鯛	鲷
鯽	鲴鲫
鯿	鳊
鰁	鲱
鰂	鲵
鰄	鲲
鰇	鲳
鰈	鲽鲸
鰉	鳇
鰊	鲮
鰋	鲰
鰍	鳅
鰏	鲾
鰐	鳄
鰒	鳆
鰓	鳃
鰥	鳏
鰧	藤
鰨	鳎
鰩	鳐
鰭	鳍
鰱	鲢
鰲	鳌
鰵	鳘
鰷	鲦
鰹	鲣
鰻	鳗
鱗	鳞
鱘	鲟
鱝	鲼
鱞	鳔
鱟	鲎
鱢	臊
鱣	鳣
鱥	鳙
鱧	鳢
鱨	鳕
鱩	鳖
鱭	鲚
鱲	鳟
鱴	鳝
鱶	鳜
鱸	鲈
鱺	鲡
鴅	鸟
鴆	鸩
鴇	鸨
鴉	鸠鸦
鴌	凫
鴓	凤
鴔	鸣
鴕	鸵
鴖	鸢
鴛	鸳
鴝	鸲
鴟	鸱
鴣	鸪
鴦	鸯
鴨	鸭
鴬	莺
鴯	鸸
鴰	鸹
鴻	鸿
鴿	鸽
鵂	鸺
鵠	鹄
鵡	鹉
鵪	鹌
鵬	鹏
鵯	鹎
鵰	雕
鵱	鹃
鵲	鹊鹆
鵳	鹁
鵼	鹈
鵽	鹅
鶇	鸫
鶉	鹑
鶏	鸡
鶓	鹋
鶚	鹗
鷀	鹚
鷂	鹞
鷅	鹛
鷌	鸧
鷓	鹧
鷔	鹤
鷗	鸥
鷙	鸷
鷚	鹨
鷛	鹘鹱
鷜	鹣
鷥	鸶
鷦	鹪
鷯	鹩
鷲	鹫
鷳	鹇
鷸	鹬
鷺	鹭
鸞	鸾
鹯	鸬
鹷	鹦
鹸	鹳
鹹	碱
鹺	鹾鹂
鹽	盐
麐	麟
麕	麇
麗	丽
麞	獐
麤	粗
麥	麦
麩	麸
麽	么
點	点
黡	曲
黨	党
黱	黛
黲	黪
黷	黩
黽	黾
黿	鼋
鼁	黉
鼂	鼌
鼉	鼍
齙	龅
齜	呲鼹龇
齟	龃
齠	龆
齡	龄
齦	啃龈
齩	咬
齪	龊
齬	齐龉
齲	齿龋
齴	龀
齶	腭
齷	龌
龍	龙
龐	庞
龕	龛
龜	龟
